00000000000000000000000000000000000000000000000000000000000000000000000000000000
00000000000000000000000000000000000000000000000000000000000000000000000000000000
00000000000000000000000000000000000000000000000000000000000000000000000000000000
00000000000000000000000000000000000000000000000000000000000000000000000000000000
00000000000000000000000000000000000000000000000000000000000000000000000000000000
00000000000000000000000000000000000000000000000000000000000000000000000000000000
00000000000000000000000000000000000000000000000000000000000000000000000000000000
00000000000000000000000000000000000000000000000000000000000000000000000000000000
00000000000000000000000000000000000000000000000000000000000000000000000000000000
00000000000000000000000000000000000000000000000000000000000000000000000000000000
00000000000000000000000000000000000000000000000000000000000000000000000000000000
00000000000000000000000000000000000000000000000000000000000000000000000000000000
00000000000000000000000000000000000000000000000000000000000000000000000000000000
00000000000000000000000000000000000000000000000000000000000000000000000000000000
00000000000000000000000000000000000000000000000000000000000000000000000000000000
00000000000000000000000000000000000000000000000000000000000000000000000000000000
00000000000000000000000000000000000000000000000000000000000000000000000000000000
00000000000000000000000000000000000000000000000000000000000000000000000000000000
00000000000000000000000000000000000000000000000000000000000000000000000000000000
00000000000000000000000000000000000000000000000000000000000000000000000000000000
00000000000000000000000000000000000000000000000000000000000000000000000000000000
00000000000000000000000000000000000000000000000000000000000000000000000000000000
00000000000000000000000000000000000000000000000000002222211222222222222222222222
00000000000000000000000002222222222222222222222222222222211222222222222222222222
00000022222222222222222222222222222222222222222222222222211222222222222222222222
22222222222222222222222222222222222222222222222222222222211222222222222222222222
22222222222222222222222222222222222222222222222222222222211222222222222222222222
22222222222222222222222222222222222222222222222222222222211222222222222222222222
22222222222222222222222222222222222222222222222222222222211222222222222222222222
22222222222222222222222222222222222222222222222222222222211222222222222222222222
22222222222222222222222222222222222222222222222222222222211222222222222222222222
22222222222222222222222222222222222222222222222222222222211222222222222222222222
22222222222222222222222222222222222222222222222222222222211222222222222222222222
22222222222222222222222222222222222222222222222222222222211222222222222222222222
22222222222222222222222222222222222222222222222222222222211222222222222222222222
22222222222222222222222222222222222222222222222222222222211222222222222222222222
22222222222222222222222222222222222222222222222222222222211222222222222222222222
22222222222222222222222222222222222222222222222222222222211222222222222222222222
22222222222222222222222222222222222222222222222222222222211222222222222222222222
22222222222222222222222222222222222222222222222222222222211222222222222222222222
22222222222222222222222222222222222222222222222222222222211222222222222222222222
22222222222222222222222222222222222222222222222222222222211222222222222222222222
22222222222222222222222222222222222222222222222222222222211222222222222222222222
22222222222222222222222222222222222222222222222222222222211222222222222222222222
22222222222222222222222222222222222222222222222222222222211222222222222222222222

