00000000000000000000000000000000000000000000000000000000000000000000000000000000
00000000000000000000000000000000000000000000000000000000000000000000000000000000
00000000000000000000000000000000000000000000000000000000000000000000000000000000
00000000000000000000000000000000000000000000000000000000000000000000000000000000
00000000000000000000000000000000000000000000000000000000000000000000000000000000
00000000000000000000000000000000000000000000000000000000000000000000000000000000
00000000000000000000000000000000000000000000000000000000000000000000000000000000
00000000000000000000000000000000000000000000000000000000000000000000000000000000
00000000000000000000000000000000000000000000000000000000000000000000000000000000
00000000000000000000000000000000000000000000000000000000000000000000000000000000
00000000000000000000000000000000000000000000000000000000000000000000000000000000
00000000000000000000000000000000000000000000000000000000000000000000000000000000
00000000000000000000000000000000000000000000000000000000000000000000000000000000
00000000000000000000000000000000000000000000000000000000000000000000000000000000
00000000000000000000000000000000000000000000000000000000000000000000000000000000
00000000000000000000000000000000000000000000000000000000000000000000000000000000
00000000000000000000000000000000000000000000000000000000000000000000000000000000
00000000000000000000000000000000000000000000000000000000000000000000000000000000
00000000000000000000000000000000000000000000000000000000000000000000000000000000
00000000000000000000000000000000000000000000000000000000000000000000000000000000
00000000000000000000000000000000000000000000000000000000000000000000000000000000
00000000000000000000000000000000000000000000000000000000000000000000000000000000
22222222222222222222222222222222222222222222222222222222222222222000000000000000
22222222222222222222222222222222222222222222222222222222222222222200000000000000
22222222222222222222222222222222222222222222222222222222222222222222000000000000
22222222222222222222222222222222222222222222222222222222222222222222220000000000
22222222222222222222222222222222222222222222222222222222222222222222222200000000
22222222222222222222222222222222222222222222222222222222222222222222222220000000
22222222222222222222222222222222222222222222222222222222222222222222222222000000
22222222222222222222222222222222222222222222222222222222222222222222222222000000
22222222222222222222222222222222222222222222222222222222222222222222222222200000
22222222222222222222222222222222222222222222222222222222222222222222222222220000
22222222222222222222222222222222222222222222222222222222222222222222222222220000
22222222222222222222222222222222222222222222222222222222222222222222222222222000
22222222222222222222222222222222222222222222222222222222222222222222222222222200
22222222222222222222222222222222222222222222222222222222222222222222222222222200
22222222222222222222222222222222222222222222222222222222222222222222222222222220
22222222222222222222222222222222222222222222222222222222222222222222222222222220
22222222222222222222222222222222222222222222222222222222222222222222222222222222
22222222222222222222222222222222222222222222222222222222222222222222222222222222
22222222222222222222222222222222222222222222222222222222222222222222222222222222
22222222222222222222222222222222222222222222222222222222222222222222222222222222
22222222222222222222222222222222222222222222222222222222222222222222222222222222
22222222222222222222222222222222222222222222222222222222222222222222222222222222
22222222222222222222222222222222222222222222222222222222222222222222222222222222

